,Datum,Aantal testen,Positieve testresultaten,positiviteitsratio,Negatieve testresultaten
0,2020-03-01,82,0,0.0,82
1,2020-03-02,317,10,3.1545741324921135,307
2,2020-03-03,538,21,3.903345724907063,517
3,2020-03-04,701,37,5.2781740370898715,664
4,2020-03-05,773,65,8.408796895213454,708
5,2020-03-06,1119,81,7.238605898123325,1038
6,2020-03-07,475,36,7.578947368421053,439
7,2020-03-08,483,49,10.144927536231885,434
8,2020-03-09,610,37,6.065573770491803,573
9,2020-03-10,804,57,7.08955223880597,747
10,2020-03-11,1108,101,9.115523465703971,1007
11,2020-03-12,1438,145,10.083449235048679,1293
12,2020-03-13,2524,242,9.58795562599049,2282
13,2020-03-14,2171,179,8.245048364808843,1992
14,2020-03-15,1269,177,13.947990543735225,1092
15,2020-03-16,1892,268,14.16490486257928,1624
16,2020-03-17,2255,434,19.246119733924612,1821
17,2020-03-18,2714,494,18.201915991156962,2220
18,2020-03-19,3395,725,21.354933726067745,2670
19,2020-03-20,3120,805,25.801282051282055,2315
20,2020-03-21,2276,648,28.471001757469246,1628
21,2020-03-22,1414,423,29.915134370579917,991
22,2020-03-23,3322,1115,33.56411800120409,2207
23,2020-03-24,3975,1331,33.484276729559745,2644
24,2020-03-25,4282,1358,31.71415226529659,2924
25,2020-03-26,4363,1424,32.63809305523722,2939
26,2020-03-27,4930,1535,31.135902636916835,3395
27,2020-03-28,3850,1286,33.4025974025974,2564
28,2020-03-29,2419,828,34.22902025630426,1591
29,2020-03-30,4101,1307,31.870275542550598,2794
30,2020-03-31,6432,1913,29.741915422885572,4519
31,2020-04-01,5891,1639,27.822101510779156,4252
32,2020-04-02,6088,1657,27.217477003942182,4431
33,2020-04-03,6718,1898,28.252456088121463,4820
34,2020-04-04,5368,1497,27.88748137108793,3871
35,2020-04-05,3828,925,24.16405433646813,2903
36,2020-04-06,5840,1447,24.777397260273972,4393
37,2020-04-07,7509,1933,25.742442402450394,5576
38,2020-04-08,7972,1721,21.588058203712997,6251
39,2020-04-09,8224,1864,22.66536964980545,6360
40,2020-04-10,8537,1833,21.471242825348483,6704
41,2020-04-11,8148,1542,18.924889543446245,6606
42,2020-04-12,7287,1404,19.267188143268836,5883
43,2020-04-13,6698,1146,17.109584950731563,5552
44,2020-04-14,8163,1421,17.407815754012006,6742
45,2020-04-15,10984,1932,17.589220684632192,9052
46,2020-04-16,10742,1494,13.908024576428971,9248
47,2020-04-17,11300,1586,14.035398230088495,9714
48,2020-04-18,10312,1431,13.877036462373935,8881
49,2020-04-19,7200,807,11.208333333333332,6393
50,2020-04-20,11916,1510,12.672037596508895,10406
51,2020-04-21,10878,1003,9.220444934730649,9875
52,2020-04-22,15588,1484,9.520143700282269,14104
53,2020-04-23,17379,1145,6.588411300995454,16234
54,2020-04-24,19068,1013,5.312565554856303,18055
55,2020-04-25,17193,792,4.606525911708253,16401
56,2020-04-26,13879,533,3.8403343180344405,13346
57,2020-04-27,17472,715,4.092261904761905,16757
58,2020-04-28,20371,798,3.917333464238378,19573
59,2020-04-29,22660,706,3.115622241835834,21954
60,2020-04-30,24870,691,2.7784479292320063,24179
61,2020-05-01,23551,442,1.8767780561334977,23109
62,2020-05-02,16482,388,2.3540832423249607,16094
63,2020-05-03,13430,286,2.129560685033507,13144
64,2020-05-04,23199,523,2.2544075175654124,22676
65,2020-05-05,21521,737,3.424562055666558,20784
66,2020-05-06,20762,696,3.352278200558713,20066
67,2020-05-07,22031,647,2.936770913712496,21384
68,2020-05-08,25882,680,2.6273085542075574,25202
69,2020-05-09,21012,473,2.2510946126023224,20539
70,2020-05-10,12301,368,2.991626697016503,11933
71,2020-05-11,11055,341,3.084577114427861,10714
72,2020-05-12,20515,558,2.7199610041433098,19957
73,2020-05-13,23140,512,2.2126188418323247,22628
74,2020-05-14,20263,451,2.2257316290776292,19812
75,2020-05-15,20884,506,2.4229074889867843,20378
76,2020-05-16,14425,330,2.2876949740034664,14095
77,2020-05-17,10103,191,1.8905275660694842,9912
78,2020-05-18,10710,269,2.511671335200747,10441
79,2020-05-19,16701,463,2.772289084485959,16238
80,2020-05-20,18759,438,2.3348792579561812,18321
81,2020-05-21,9878,234,2.3689005871633935,9644
82,2020-05-22,13278,330,2.4853140533212836,12948
83,2020-05-23,9227,311,3.37054297171345,8916
84,2020-05-24,7022,193,2.748504699515807,6829
85,2020-05-25,9982,211,2.11380484872771,9771
86,2020-05-26,16225,384,2.3667180277349766,15841
87,2020-05-27,17772,290,1.6317803286067973,17482
88,2020-05-28,13090,236,1.8029029793735676,12854
89,2020-05-29,13616,251,1.8434195064629848,13365
90,2020-05-30,9729,183,1.8809744064138143,9546
91,2020-05-31,6795,123,1.8101545253863136,6672
92,2020-06-01,5438,88,1.6182420007355647,5350
93,2020-06-02,10656,142,1.3325825825825826,10514
94,2020-06-03,14800,243,1.6418918918918917,14557
95,2020-06-04,12842,268,2.0869023516586203,12574
96,2020-06-05,13083,210,1.6051364365971106,12873
97,2020-06-06,11865,177,1.4917825537294565,11688
98,2020-06-07,7307,98,1.3411796907075408,7209
99,2020-06-08,11013,160,1.4528284754381187,10853
100,2020-06-09,15085,194,1.2860457408021213,14891
101,2020-06-10,14326,166,1.1587323747033367,14160
102,2020-06-11,13941,175,1.2552901513521268,13766
103,2020-06-12,13743,151,1.0987411773266391,13592
104,2020-06-13,12521,127,1.0142959827489817,12394
105,2020-06-14,6245,51,0.8166533226581264,6194
106,2020-06-15,11905,101,0.8483830323393532,11804
107,2020-06-16,15194,166,1.0925365275766752,15028
108,2020-06-17,15312,161,1.0514629049111808,15151
109,2020-06-18,13959,156,1.1175585643670751,13803
110,2020-06-19,13395,145,1.0824934677118327,13250
111,2020-06-20,12534,119,0.9494175841710547,12415
112,2020-06-21,6602,46,0.6967585580127235,6556
113,2020-06-22,11129,84,0.7547847964776709,11045
114,2020-06-23,17383,191,1.098774664902491,17192
115,2020-06-24,18466,150,0.8123036932741254,18316
116,2020-06-25,15202,123,0.8091040652545718,15079
117,2020-06-26,14554,175,1.2024185790847877,14379
118,2020-06-27,10950,90,0.821917808219178,10860
119,2020-06-28,6184,56,0.9055627425614489,6128
120,2020-06-29,11992,83,0.6921280853902602,11909
121,2020-06-30,16062,129,0.8031378408666418,15933
122,2020-07-01,15172,155,1.0216187714210387,15017
123,2020-07-02,13607,125,0.9186448151686631,13482
124,2020-07-03,12376,124,1.0019392372333549,12252
125,2020-07-04,10003,115,1.1496551034689595,9888
126,2020-07-05,5800,43,0.7413793103448276,5757
127,2020-07-06,10721,85,0.7928364891334763,10636
128,2020-07-07,13924,111,0.7971847170353347,13813
129,2020-07-08,13859,161,1.1616999783534165,13698
130,2020-07-09,12535,147,1.1727163940965297,12388
131,2020-07-10,12022,133,1.1063051073032772,11889
132,2020-07-11,9290,127,1.3670613562970937,9163
133,2020-07-12,5622,66,1.1739594450373532,5556
134,2020-07-13,10241,134,1.3084659701201053,10107
135,2020-07-14,15070,202,1.340411413404114,14868
136,2020-07-15,16354,278,1.6998899351840526,16076
137,2020-07-16,14479,284,1.9614614268941226,14195
138,2020-07-17,13993,281,2.008146930608161,13712
139,2020-07-18,10449,257,2.459565508661116,10192
140,2020-07-19,6279,161,2.564102564102564,6118
141,2020-07-20,11901,236,1.9830266364171079,11665
142,2020-07-21,11987,364,3.036623008258947,11623
143,2020-07-22,13283,207,1.5583828954302492,13076
144,2020-07-23,18285,409,2.236806125239267,17876
145,2020-07-24,18678,615,3.2926437520077094,18063
146,2020-07-25,14507,330,2.274763907079341,14177
147,2020-07-26,10981,432,3.9340679355249977,10549
148,2020-07-27,14560,322,2.2115384615384617,14238
149,2020-07-28,25521,643,2.5194937502448966,24878
150,2020-07-29,25480,769,3.0180533751962324,24711
151,2020-07-30,26134,840,3.2142037192928754,25294
152,2020-07-31,21530,674,3.130515559684162,20856
153,2020-08-01,20418,574,2.8112449799196786,19844
154,2020-08-02,11695,469,4.010260795211629,11226
155,2020-08-03,16827,456,2.709930468889285,16371
156,2020-08-04,25451,640,2.5146359671525675,24811
157,2020-08-05,26379,1015,3.847757686038136,25364
158,2020-08-06,23195,898,3.8715240353524463,22297
159,2020-08-07,22826,860,3.767633400508193,21966
160,2020-08-08,16668,708,4.2476601871850255,15960
161,2020-08-09,9956,445,4.469666532744074,9511
162,2020-08-10,17036,508,2.98192063864757,16528
163,2020-08-11,25658,878,3.4219346792423417,24780
164,2020-08-12,22073,824,3.733067548588773,21249
165,2020-08-13,21859,786,3.595772908184272,21073
166,2020-08-14,18676,701,3.753480402655815,17975
167,2020-08-15,12981,370,2.8503196980201833,12611
168,2020-08-16,8932,274,3.0676220331392745,8658
169,2020-08-17,17998,494,2.7447494166018447,17504
170,2020-08-18,27111,713,2.6299288111836523,26398
171,2020-08-19,23088,644,2.7893277893277895,22444
172,2020-08-20,23852,948,3.974509475096428,22904
173,2020-08-21,20813,695,3.3392591168980927,20118
174,2020-08-22,15631,536,3.4290832320388973,15095
175,2020-08-23,8529,178,2.0869973033180913,8351
176,2020-08-24,17609,377,2.1409506502356748,17232
177,2020-08-25,27040,675,2.496301775147929,26365
178,2020-08-26,24596,631,2.5654577980159377,23965
179,2020-08-27,21308,552,2.590576309367374,20756
180,2020-08-28,25114,729,2.9027633989010115,24385
181,2020-08-29,19052,575,3.0180558471551544,18477
182,2020-08-30,10600,248,2.339622641509434,10352
183,2020-08-31,19657,367,1.8670193824083021,19290
184,2020-09-01,28223,495,1.7538886723594234,27728
185,2020-09-02,30069,798,2.653896039110047,29271
186,2020-09-03,24017,751,3.126951742515718,23266
187,2020-09-04,26583,845,3.1787232441786104,25738
188,2020-09-05,19740,616,3.120567375886525,19124
189,2020-09-06,10963,406,3.703365867007206,10557
190,2020-09-07,23129,584,2.5249686540706473,22545
191,2020-09-08,35123,773,2.2008370583378416,34350
192,2020-09-09,35047,986,2.8133649099780293,34061
193,2020-09-10,36232,1214,3.3506292779863105,35018
194,2020-09-11,38042,1271,3.341044109142527,36771
195,2020-09-12,27126,1036,3.8192140381921402,26090
196,2020-09-13,19155,814,4.249543200208823,18341
197,2020-09-14,29307,1011,3.4496877879005017,28296
198,2020-09-15,42303,1499,3.5434839136704257,40804
199,2020-09-16,46674,1670,3.5780091699875736,45004
200,2020-09-17,43222,1915,4.4306140391467315,41307
201,2020-09-18,41428,1751,4.226610022207203,39677
202,2020-09-19,26392,1187,4.4975750227341615,25205
203,2020-09-20,21874,1209,5.527109810734205,20665
204,2020-09-21,34932,1780,5.095614336425054,33152
205,2020-09-22,45049,2051,4.552820262380964,42998
206,2020-09-23,44434,2273,5.115452131250843,42161
207,2020-09-24,40555,2226,5.488842312908396,38329
208,2020-09-25,37845,2097,5.5410225921522,35748
209,2020-09-26,32846,1882,5.729769226085368,30964
210,2020-09-27,20108,1218,6.057290630594788,18890
211,2020-09-28,28309,2066,7.2980324278498,26243
212,2020-09-29,47447,2869,6.046746896537189,44578
213,2020-09-30,45996,2984,6.487520653969911,43012
214,2020-10-01,41112,3746,9.111694882272815,37366
215,2020-10-02,41148,3786,9.200933216681248,37362
216,2020-10-03,33583,2940,8.75442932436054,30643
217,2020-10-04,17641,1710,9.693328042627968,15931
218,2020-10-05,26934,2657,9.864854830325982,24277
219,2020-10-06,45178,4605,10.193014298995086,40573
220,2020-10-07,54451,5943,10.914400102844759,48508
221,2020-10-08,50179,6253,12.461388230136112,43926
222,2020-10-09,53778,7066,13.139201904124361,46712
223,2020-10-10,47610,6205,13.032976265490442,41405
224,2020-10-11,30403,4010,13.189487879485576,26393
225,2020-10-12,44561,7293,16.36632930140706,37268
226,2020-10-13,59566,8478,14.23295168384649,51088
227,2020-10-14,72984,11637,15.94459059519895,61347
228,2020-10-15,66278,10362,15.634147077461602,55916
229,2020-10-16,68733,11569,16.831798408333697,57164
230,2020-10-17,61911,10455,16.88714444929011,51456
231,2020-10-18,44720,8365,18.705277280858677,36355
232,2020-10-19,56014,10513,18.76852215517549,45501
233,2020-10-20,78642,15637,19.883777116553496,63005
234,2020-10-21,81011,16563,20.44537161620027,64448
235,2020-10-22,80226,19679,24.529454291626156,60547
236,2020-10-23,69369,18236,26.288399717453043,51133
237,2020-10-24,63863,17516,27.42746191065249,46347
238,2020-10-25,39564,12296,31.0787584672935,27268
239,2020-10-26,50298,16089,31.98735536204223,34209
240,2020-10-27,71727,22009,30.684400574400154,49718
241,2020-10-28,78163,22903,29.301587707738957,55260
242,2020-10-29,71988,20212,28.076901705839862,51776
243,2020-10-30,66049,17738,26.855819164559648,48311
244,2020-10-31,54627,13415,24.557453274022002,41212
245,2020-11-01,24219,6423,26.520500433543916,17796
246,2020-11-02,28946,7298,25.21246458923513,21648
247,2020-11-03,54881,14904,27.15693956013921,39977
248,2020-11-04,45016,11477,25.495379420650437,33539
249,2020-11-05,45737,10150,22.192098301156612,35587
250,2020-11-06,39376,7767,19.72521332791548,31609
251,2020-11-07,32366,7014,21.670889204721004,25352
252,2020-11-08,13328,2798,20.99339735894358,10530
253,2020-11-09,22390,4564,20.384100044662794,17826
254,2020-11-10,39214,8344,21.278114958943235,30870
255,2020-11-11,31808,6206,19.510814889336018,25602
256,2020-11-12,28061,5148,18.345746765974127,22913
257,2020-11-13,37838,7026,18.56863470585126,30812
258,2020-11-14,26487,5080,19.179219994714387,21407
259,2020-11-15,13851,2589,18.69179120641109,11262
260,2020-11-16,21481,3143,14.631534844746522,18338
261,2020-11-17,40670,6169,15.168428817310057,34501
262,2020-11-18,36763,4809,13.081086962435057,31954
263,2020-11-19,35332,4375,12.38254273746179,30957
264,2020-11-20,34450,3893,11.30043541364296,30557
265,2020-11-21,21547,2569,11.92277347194505,18978
266,2020-11-22,10732,1324,12.33693626537458,9408
267,2020-11-23,22533,2382,10.571162295300226,20151
268,2020-11-24,42283,4364,10.320932762575977,37919
269,2020-11-25,37203,3350,9.004650162621294,33853
270,2020-11-26,34176,3225,9.436446629213483,30951
271,2020-11-27,33708,2841,8.428266286934852,30867
272,2020-11-28,25829,2584,10.004258778891943,23245
273,2020-11-29,9634,884,9.175835582312644,8750
274,2020-11-30,23565,2077,8.813918947591768,21488
275,2020-12-01,44483,3726,8.376233617336961,40757
276,2020-12-02,36707,3171,8.638679270983737,33536
277,2020-12-03,34183,3021,8.837726355205804,31162
278,2020-12-04,36261,3056,8.427787430021235,33205
279,2020-12-05,24783,2171,8.760037122220877,22612
280,2020-12-06,10574,993,9.390958955929639,9581
281,2020-12-07,26682,2137,8.009144741773481,24545
282,2020-12-08,46134,3613,7.8315342263840115,42521
283,2020-12-09,41727,3306,7.922927600833993,38421
284,2020-12-10,38364,3155,8.223855698050256,35209
285,2020-12-11,38847,3095,7.967153190722579,35752
286,2020-12-12,30163,2786,9.236481782316083,27377
287,2020-12-13,13696,1233,9.002628504672897,12463
288,2020-12-14,31621,2493,7.884001138483919,29128
289,2020-12-15,53290,4288,8.046537811972227,49002
290,2020-12-16,50948,3649,7.162204600769412,47299
291,2020-12-17,46544,3374,7.249054657958061,43170
292,2020-12-18,42686,3160,7.402895562948039,39526
293,2020-12-19,33067,2582,7.808389028336409,30485
294,2020-12-20,14539,1130,7.772198913267762,13409
295,2020-12-21,32641,2388,7.315952329891854,30253
296,2020-12-22,52117,3764,7.222211562446034,48353
297,2020-12-23,41375,2949,7.12749244712991,38426
298,2020-12-24,37088,2709,7.304249352890422,34379
299,2020-12-25,13169,1038,7.882147467537398,12131
300,2020-12-26,17938,1006,5.608206043037128,16932
301,2020-12-27,13530,985,7.280118255728012,12545
302,2020-12-28,29126,1904,6.5371146055071065,27222
303,2020-12-29,41573,3248,7.812763091429534,38325
304,2020-12-30,32817,2592,7.898345369777859,30225
305,2020-12-31,30601,2174,7.10434299532695,28427
306,2021-01-01,11997,986,8.218721347003417,11011
307,2021-01-02,18677,981,5.252449536863522,17696
308,2021-01-03,17800,1040,5.842696629213483,16760
309,2021-01-04,40473,2065,5.102166876683221,38408
310,2021-01-05,60569,3498,5.775231554095329,57071
311,2021-01-06,55574,3357,6.04059452261849,52217
312,2021-01-07,44543,2500,5.6125541611476555,42043
313,2021-01-08,46688,2308,4.943454420836189,44380
314,2021-01-09,38438,1888,4.9118060252874765,36550
315,2021-01-10,23057,1136,4.926920241141519,21921
316,2021-01-11,44176,2116,4.789931184353495,42060
317,2021-01-12,67378,3367,4.997180088456172,64011
318,2021-01-13,57125,3034,5.311159737417944,54091
319,2021-01-14,43536,2430,5.581587651598677,41106
320,2021-01-15,44127,2482,5.624674235728692,41645
321,2021-01-16,34036,2010,5.905511811023622,32026
322,2021-01-17,16859,1090,6.4653894062518535,15769
323,2021-01-18,37752,1829,4.844776435685526,35923
324,2021-01-19,63597,3550,5.582024309322767,60047
325,2021-01-20,53621,2891,5.391544357621082,50730
326,2021-01-21,45744,2723,5.952693249387898,43021
327,2021-01-22,50900,3056,6.00392927308448,47844
328,2021-01-23,38566,2076,5.382979826790437,36490
329,2021-01-24,21784,1310,6.013587954461991,20474
330,2021-01-25,44412,2244,5.052688462577682,42168
331,2021-01-26,65254,3629,5.561344898397033,61625
332,2021-01-27,62390,3245,5.201154031094727,59145
333,2021-01-28,56085,3176,5.662833199607738,52909
334,2021-01-29,56501,3367,5.9591865630696805,53134
335,2021-01-30,47242,2735,5.789339994073071,44507
336,2021-01-31,22320,1356,6.075268817204301,20964
337,2021-02-01,45953,2272,4.944182099101256,43681
338,2021-02-02,68422,3605,5.268773201601824,64817
339,2021-02-03,60881,2998,4.924360637965868,57883
340,2021-02-04,54346,2984,5.490744489014831,51362
341,2021-02-05,57268,2961,5.17042676538381,54307
342,2021-02-06,42194,2227,5.278001611603546,39967
343,2021-02-07,19231,1042,5.418334979980241,18189
344,2021-02-08,44976,1858,4.131092138029171,43118
345,2021-02-09,60931,3123,5.125469793701072,57808
346,2021-02-10,50075,2506,5.004493260109835,47569
347,2021-02-11,46441,2513,5.4111668568721605,43928
348,2021-02-12,46699,2404,5.1478618385832675,44295
349,2021-02-13,34249,1970,5.751992758912669,32279
350,2021-02-14,16116,958,5.944403077686771,15158
351,2021-02-15,38745,2016,5.203252032520325,36729
352,2021-02-16,49591,3120,6.291464176967596,46471
353,2021-02-17,43439,2791,6.425101866985888,40648
354,2021-02-18,40730,2945,7.230542597593911,37785
355,2021-02-19,42376,2985,7.044081555597508,39391
356,2021-02-20,34224,2460,7.187938288920057,31764
357,2021-02-21,17084,1272,7.445563099976586,15812
358,2021-02-22,40471,2345,5.794272441995503,38126
359,2021-02-23,54999,3705,6.7364861179294175,51294
360,2021-02-24,49263,3357,6.814444918092686,45906
361,2021-02-25,41751,3042,7.286053028669973,38709
362,2021-02-26,47451,3204,6.752228614781563,44247
363,2021-02-27,37829,2483,6.563747389568849,35346
364,2021-02-28,16566,998,6.024387299287698,15568
365,2021-03-01,43497,2222,5.108398280341174,41275
366,2021-03-02,57971,3725,6.425626606406652,54246
367,2021-03-03,51473,3171,6.160511336040255,48302
368,2021-03-04,47117,3219,6.831929027739457,43898
369,2021-03-05,52786,3138,5.944758079793885,49648
370,2021-03-06,39335,2482,6.3099021227914065,36853
371,2021-03-07,17163,1139,6.636368933170192,16024
372,2021-03-08,44052,2538,5.761372922909289,41514
373,2021-03-09,62119,4074,6.5583798837714715,58045
374,2021-03-10,56191,3768,6.705700201099821,52423
375,2021-03-11,51734,3937,7.610082344299688,47797
376,2021-03-12,58379,4013,6.8740471744976785,54366
377,2021-03-13,45927,3314,7.21579898534631,42613
378,2021-03-14,21637,1712,7.912372325183712,19925
379,2021-03-15,49069,3394,6.916790641749373,45675
380,2021-03-16,74480,5572,7.481203007518797,68908
381,2021-03-17,67415,5176,7.677816509678855,62239
382,2021-03-18,67008,5668,8.458691499522446,61340
383,2021-03-19,73727,5459,7.404343049357766,68268
384,2021-03-20,56612,4382,7.740408393980075,52230
385,2021-03-21,28111,2465,8.768809362882857,25646
386,2021-03-22,57461,4068,7.079584413776301,53393
387,2021-03-23,87517,6671,7.622519053441046,80846
388,2021-03-24,80605,6209,7.702996092053843,74396
389,2021-03-25,81764,6682,8.172300768064185,75082
390,2021-03-26,79150,5896,7.44914718888187,73254
391,2021-03-27,66250,5358,8.087547169811321,60892
392,2021-03-28,28744,2431,8.457417200111328,26313
393,2021-03-29,56692,4372,7.71184646863755,52320
394,2021-03-30,81747,6511,7.964818280793179,75236
395,2021-03-31,73944,5832,7.8870496592015575,68112
396,2021-04-01,64389,5058,7.855379024367516,59331
397,2021-04-02,67998,5535,8.139945292508603,62463
398,2021-04-03,46545,4201,9.025674078848427,42344
399,2021-04-04,23832,2332,9.785162806310844,21500
400,2021-04-05,22014,1784,8.103933860270738,20230
401,2021-04-06,48047,4069,8.468790975503152,43978
402,2021-04-07,60366,5530,9.160785872842329,54836
403,2021-04-08,49818,5392,10.823397165683087,44426
404,2021-04-09,48927,5138,10.501359167739693,43789
405,2021-04-10,36338,3626,9.978534867081294,32712
406,2021-04-11,19595,2014,10.278132176575657,17581
407,2021-04-12,41913,3587,8.558203898551762,38326
408,2021-04-13,53668,5432,10.121487664902736,48236
409,2021-04-14,44239,4514,10.203666448156604,39725
410,2021-04-15,42007,4281,10.191158616421072,37726
411,2021-04-16,44389,4463,10.0542927301809,39926
412,2021-04-17,36490,3603,9.87393806522335,32887
413,2021-04-18,20096,1864,9.275477707006369,18232
414,2021-04-19,44407,3711,8.356790596077195,40696
415,2021-04-20,58012,5800,9.997931462456043,52212
416,2021-04-21,49802,4876,9.790771454961648,44926
417,2021-04-22,47724,4204,8.808984997066466,43520
418,2021-04-23,51599,4459,8.64164034186709,47140
419,2021-04-24,38890,2993,7.696065826690666,35897
420,2021-04-25,20996,1632,7.772909125547724,19364
421,2021-04-26,48336,3299,6.825140681893413,45037
422,2021-04-27,58931,4751,8.061970779386062,54180
423,2021-04-28,54539,4108,7.532224646583178,50431
424,2021-04-29,54636,3991,7.304707518852038,50645
425,2021-04-30,57085,3807,6.669002364894455,53278
426,2021-05-01,37609,2525,6.713818500890745,35084
427,2021-05-02,21121,1579,7.475971781639126,19542
428,2021-05-03,50202,3045,6.0654953985896976,47157
429,2021-05-04,65867,4682,7.1082636221476605,61185
430,2021-05-05,60726,3928,6.468399038303198,56798
431,2021-05-06,63620,4172,6.557686262181704,59448
432,2021-05-07,64017,3922,6.126497649061968,60095
433,2021-05-08,43810,2752,6.281670851403789,41058
434,2021-05-09,22620,1550,6.852343059239612,21070
435,2021-05-10,45956,2462,5.35729828531639,43494
436,2021-05-11,65366,3791,5.799651194810758,61575
437,2021-05-12,56897,3342,5.873771903615305,53555
438,2021-05-13,30135,1996,6.623527459764393,28139
439,2021-05-14,40647,2250,5.535463871872462,38397
440,2021-05-15,36101,2187,6.058003933409046,33914
441,2021-05-16,19948,1193,5.980549428514137,18755
442,2021-05-17,41496,2072,4.993252361673414,39424
443,2021-05-18,73991,4271,5.772323660985795,69720
444,2021-05-19,64318,3594,5.587860319039771,60724
445,2021-05-20,59580,3294,5.528700906344411,56286
446,2021-05-21,55461,2894,5.218081174158417,52567
447,2021-05-22,39979,2079,5.200230120813427,37900
448,2021-05-23,21809,1120,5.135494520610757,20689
449,2021-05-24,25088,1021,4.069674744897959,24067
450,2021-05-25,51691,2234,4.321835522624829,49457
451,2021-05-26,64293,3218,5.005210520585445,61075
452,2021-05-27,55286,2634,4.764316463480809,52652
453,2021-05-28,53480,2496,4.667165295437547,50984
454,2021-05-29,37643,1743,4.630342958850251,35900
455,2021-05-30,20898,931,4.454971767633267,19967
456,2021-05-31,49998,1622,3.244129765190608,48376
457,2021-06-01,54512,2215,4.0633255063105365,52297
458,2021-06-02,50607,1846,3.647716719030964,48761
459,2021-06-03,49576,1713,3.455300952073584,47863
460,2021-06-04,49597,1733,3.49416295340444,47864
461,2021-06-05,38541,1118,2.900806932876677,37423
462,2021-06-06,19366,565,2.917484250748735,18801
463,2021-06-07,43169,1064,2.4647316361277767,42105
464,2021-06-08,49988,1479,2.958710090421701,48509
465,2021-06-09,44785,1075,2.4003572624762755,43710
466,2021-06-10,43474,972,2.2358191102728067,42502
467,2021-06-11,44203,1009,2.2826504988349203,43194
468,2021-06-12,34430,716,2.079581760092942,33714
469,2021-06-13,18612,330,1.773049645390071,18282
470,2021-06-14,43430,652,1.5012664057103384,42778
471,2021-06-15,47243,873,1.847892809516754,46370
472,2021-06-16,42937,621,1.4463050515872091,42316
473,2021-06-17,42488,593,1.3956881943136885,41895
474,2021-06-18,45029,533,1.1836816273956783,44496
475,2021-06-19,31765,456,1.43554226349756,31309
476,2021-06-20,20872,275,1.3175546186278266,20597
477,2021-06-21,39593,400,1.0102795948778824,39193
478,2021-06-22,46523,569,1.2230509640392924,45954
479,2021-06-23,45785,465,1.0156164682756361,45320
480,2021-06-24,50828,513,1.0092862201935942,50315
481,2021-06-25,48742,514,1.0545320257683313,48228
482,2021-06-26,39132,389,0.9940713482571808,38743
483,2021-06-27,24134,299,1.2389160520427611,23835
484,2021-06-28,52520,509,0.9691546077684691,52011
485,2021-06-29,70891,683,0.9634509317120651,70208
486,2021-06-30,74959,668,0.891153830760816,74291
487,2021-07-01,82923,1034,1.2469399322262822,81889
488,2021-07-02,81699,850,1.040404411314704,80849
489,2021-07-03,56045,702,1.2525649032027835,55343
490,2021-07-04,33904,520,1.5337423312883436,33384
491,2021-07-05,53837,795,1.476679606961755,53042
492,2021-07-06,60213,1148,1.9065650274857588,59065
493,2021-07-07,65299,1219,1.8667973475857211,64080
494,2021-07-08,76710,1344,1.752053187328901,75366
495,2021-07-09,73154,1361,1.86045875823605,71793
496,2021-07-10,61092,1285,2.103385058600144,59807
497,2021-07-11,36897,917,2.4852969076076645,35980
498,2021-07-12,58699,1405,2.3935671817237094,57294
499,2021-07-13,70555,1787,2.5327758486287295,68768
500,2021-07-14,75247,1592,2.1156989647427804,73655
501,2021-07-15,86996,1528,1.7564025932226768,85468
502,2021-07-16,96027,1671,1.7401355868661939,94356
503,2021-07-17,72603,1483,2.042615318926215,71120
504,2021-07-18,42843,1062,2.4788180099432813,41781
505,2021-07-19,65182,1657,2.5421128532416923,63525
506,2021-07-20,76330,2336,3.0603956504650855,73994
507,2021-07-21,46067,1501,3.258297696832874,44566
508,2021-07-22,70010,1456,2.0797028995857736,68554
509,2021-07-23,78130,2144,2.7441443747600154,75986
510,2021-07-24,55151,1555,2.819531830791826,53596
511,2021-07-25,31067,1066,3.4312936556474716,30001
512,2021-07-26,50864,1583,3.1122208241585403,49281
513,2021-07-27,55980,2142,3.8263665594855305,53838
514,2021-07-28,50628,1834,3.6225013826341157,48794
515,2021-07-29,60162,1825,3.033476280708753,58337
516,2021-07-30,70601,1984,2.8101584963385786,68617
517,2021-07-31,60211,1772,2.9429838401620967,58439
518,2021-08-01,35308,1130,3.200407839583097,34178
519,2021-08-02,55689,1836,3.296880892097183,53853
520,2021-08-03,58533,2424,4.1412536517861716,56109
521,2021-08-04,49772,2192,4.4040826167323,47580
522,2021-08-05,50464,1982,3.927552314521243,48482
523,2021-08-06,57334,2163,3.7726305508075484,55171
524,2021-08-07,50133,1869,3.7280832984261867,48264
525,2021-08-08,29933,1188,3.968863795810644,28745
526,2021-08-09,47740,1887,3.9526602429828235,45853
527,2021-08-10,51649,2796,5.4134639586439235,48853
528,2021-08-11,46890,2395,5.107698869695031,44495
529,2021-08-12,51419,2217,4.3116357766584334,49202
530,2021-08-13,70667,2343,3.315550398347178,68324
531,2021-08-14,56358,2238,3.971042265516874,54120
532,2021-08-15,26486,1067,4.0285433814090466,25419
533,2021-08-16,43474,1860,4.278419285089939,41614
534,2021-08-17,51161,3029,5.920525400207189,48132
535,2021-08-18,45270,2415,5.334658714380384,42855
536,2021-08-19,44968,2416,5.372709482298523,42552
537,2021-08-20,53331,2287,4.288312613676848,51044
538,2021-08-21,40418,1796,4.443564748379434,38622
539,2021-08-22,26442,1358,5.135768852583012,25084
540,2021-08-23,41239,1978,4.796430563301729,39261
541,2021-08-24,46228,2908,6.290559833866921,43320
542,2021-08-25,40833,2638,6.460460901721647,38195
543,2021-08-26,42971,2575,5.992413488166438,40396
544,2021-08-27,50072,2326,4.645310752516377,47746
545,2021-08-28,42793,2074,4.846587058631084,40719
546,2021-08-29,21232,1041,4.902976639035418,20191
547,2021-08-30,41527,2040,4.912466588002986,39487
548,2021-08-31,49383,3139,6.35643845047891,46244
549,2021-09-01,39333,2485,6.317850151272468,36848
550,2021-09-02,41902,2487,5.935277552384134,39415
551,2021-09-03,48969,2295,4.686638485572505,46674
552,2021-09-04,41081,1994,4.853825369392176,39087
553,2021-09-05,19032,965,5.070407734342161,18067
554,2021-09-06,38222,2017,5.277065564334676,36205
555,2021-09-07,47098,2831,6.01087094993418,44267
556,2021-09-08,45727,2511,5.491285236293656,43216
557,2021-09-09,44401,2430,5.4728497105921035,41971
558,2021-09-10,54905,2346,4.27283489663965,52559
559,2021-09-11,45718,2104,4.602126077256223,43614
560,2021-09-12,22323,1006,4.506562737983246,21317
561,2021-09-13,41661,1766,4.238976500804109,39895
562,2021-09-14,59532,3327,5.5885910098770415,56205
563,2021-09-15,53857,2631,4.88515884657519,51226
564,2021-09-16,50370,2531,5.0248163589438155,47839
565,2021-09-17,56825,2722,4.79014518257809,54103
566,2021-09-18,45474,1911,4.202401372212693,43563
567,2021-09-19,22407,1042,4.650332485384031,21365
568,2021-09-20,45779,1980,4.3251272417484,43799
569,2021-09-21,60852,2844,4.67363439163873,58008
570,2021-09-22,54158,2512,4.63828058643229,51646
571,2021-09-23,51638,2399,4.645803478058793,49239
572,2021-09-24,54834,2357,4.2984279826385094,52477
573,2021-09-25,43877,1995,4.546801285411491,41882
574,2021-09-26,20723,991,4.782126140037639,19732
575,2021-09-27,41049,1856,4.521425613291432,39193
576,2021-09-28,56265,2835,5.038656358304452,53430
577,2021-09-29,50323,2316,4.6022693400631915,48007
578,2021-09-30,48957,2500,5.106522049962211,46457
579,2021-10-01,51986,2283,4.391566960335475,49703
580,2021-10-02,42308,1873,4.427058712300274,40435
581,2021-10-03,19154,982,5.126866450871881,18172
582,2021-10-04,41563,1883,4.530471813872916,39680
583,2021-10-05,54462,2813,5.16506922257721,51649
584,2021-10-06,50522,2719,5.381813863267487,47803
585,2021-10-07,46864,2659,5.673864800273131,44205
586,2021-10-08,56008,2795,4.990358520211399,53213
587,2021-10-09,42532,2198,5.167873601053325,40334
588,2021-10-10,20490,1071,5.226939970717423,19419
589,2021-10-11,44625,2494,5.5887955182072835,42131
590,2021-10-12,59772,4009,6.707153851301613,55763
591,2021-10-13,55782,3842,6.887526442221505,51940
592,2021-10-14,53956,3884,7.19845800281711,50072
593,2021-10-15,62158,4257,6.848675954824801,57901
594,2021-10-16,51245,3694,7.208508147136305,47551
595,2021-10-17,23895,1930,8.077003557229547,21965
596,2021-10-18,51659,3906,7.56112197293792,47753
597,2021-10-19,79672,7059,8.86007631288282,72613
598,2021-10-20,73899,6518,8.820146416054344,67381
599,2021-10-21,76724,7162,9.33475835462176,69562
600,2021-10-22,84720,7414,8.751180358829085,77306
601,2021-10-23,68074,6004,8.819813732115051,62070
602,2021-10-24,34447,3486,10.119894330420646,30961
603,2021-10-25,66452,6200,9.330042737615122,60252
604,2021-10-26,95770,9317,9.728516236817375,86453
605,2021-10-27,98621,10039,10.17937356141187,88582
606,2021-10-28,97247,9395,9.660966405133319,87852
607,2021-10-29,108344,10252,9.462452927711732,98092
608,2021-10-30,85718,7988,9.318929513054435,77730
609,2021-10-31,41511,4369,10.524921105249211,37142
610,2021-11-01,37495,4020,10.721429523936525,33475
611,2021-11-02,76535,8474,11.072058535310642,68061
612,2021-11-03,94872,12089,12.742431908255334,82783
613,2021-11-04,91174,11231,12.318204751354553,79943
614,2021-11-05,99916,11274,11.283478121622164,88642
615,2021-11-06,79939,9563,11.962871689663368,70376
616,2021-11-07,42153,5716,13.560126206912912,36437
617,2021-11-08,76368,10004,13.099727634611355,66364
618,2021-11-09,101943,15156,14.8671316323828,86787
619,2021-11-10,107911,14416,13.359157083151857,93495
620,2021-11-11,59775,8772,14.675031367628607,51003
621,2021-11-12,88960,11051,12.422437050359711,77909
622,2021-11-13,88191,12153,13.780317719495185,76038
623,2021-11-14,42763,6720,15.714519561302994,36043
624,2021-11-15,88382,13262,15.005317824896473,75120
625,2021-11-16,119236,19522,16.372572042000737,99714
626,2021-11-17,126568,19909,15.729884330952531,106659
627,2021-11-18,128625,20374,15.839844509232265,108251
628,2021-11-19,131796,20198,15.325199550820967,111598
629,2021-11-20,111225,17072,15.349067206113734,94153
630,2021-11-21,50772,8701,17.137398566138817,42071
631,2021-11-22,102366,16981,16.588515718109527,85385
632,2021-11-23,135399,23120,17.075458459811372,112279
633,2021-11-24,141929,23209,16.352542468417308,118720
634,2021-11-25,141681,22948,16.196949485110917,118733
635,2021-11-26,139493,21307,15.274601592911472,118186
636,2021-11-27,114216,17450,15.278069622469706,96766
637,2021-11-28,61920,11040,17.829457364341085,50880
638,2021-11-29,102121,17410,17.04840336463607,84711
639,2021-11-30,139108,24162,17.36923828967421,114946
640,2021-12-01,135486,22799,16.82756890010776,112687
641,2021-12-02,126995,21513,16.94003700933108,105482
642,2021-12-03,122633,19635,16.011187853187966,102998
643,2021-12-04,95707,15574,16.2725819428046,80133
644,2021-12-05,43147,8596,19.92259021484692,34551
645,2021-12-06,85928,13958,16.243832045433386,71970
646,2021-12-07,111290,19748,17.74463114385839,91542
647,2021-12-08,111862,17528,15.669306824480165,94334
648,2021-12-09,100623,16092,15.992367550162486,84531
649,2021-12-10,101017,14812,14.662878525396717,86205
650,2021-12-11,77551,11365,14.654872277597969,66186
651,2021-12-12,37388,5762,15.411361934310474,31626
652,2021-12-13,73090,9761,13.354768094130524,63329
653,2021-12-14,94396,13872,14.695537946523157,80524
654,2021-12-15,83069,11403,13.727142495997303,71666
655,2021-12-16,78391,9807,12.510364710234592,68584
656,2021-12-17,83714,8930,10.667271901951885,74784
657,2021-12-18,65452,6837,10.44582289311251,58615
658,2021-12-19,32783,4080,12.44547478876247,28703
659,2021-12-20,66013,6617,10.02378319421932,59396
660,2021-12-21,81888,9727,11.878419304415786,72161
661,2021-12-22,77256,8297,10.739618929274101,68959
662,2021-12-23,77030,8284,10.754251590289497,68746
663,2021-12-24,83290,8899,10.684355865049826,74391
664,2021-12-25,31219,3948,12.646144975816009,27271
665,2021-12-26,29704,3884,13.07568004309184,25820
666,2021-12-27,72229,10752,14.885987622700023,61477
667,2021-12-28,76564,13991,18.273601170262786,62573
668,2021-12-29,77882,14998,19.257338024190442,62884
669,2021-12-30,83484,16299,19.523501509271238,67185
670,2021-12-31,87108,16266,18.673370987739357,70842
671,2022-01-01,39318,8226,20.921715244925988,31092
672,2022-01-02,30770,6683,21.719207019824506,24087
673,2022-01-03,80586,19231,23.863946591219317,61355
674,2022-01-04,100949,29510,29.232582789329264,71439
675,2022-01-05,100639,29091,28.906288814475502,71548
676,2022-01-06,96029,26791,27.898863884868113,69238
677,2022-01-07,100845,25581,25.366651792354606,75264
678,2022-01-08,77876,20648,26.513945246288973,57228
679,2022-01-09,45935,13677,29.774681615326003,32258
680,2022-01-10,84194,25566,30.365584245908263,58628
681,2022-01-11,111597,39360,35.26976531627194,72237
682,2022-01-12,96392,34026,35.29960992613495,62366
683,2022-01-13,94480,33941,35.9240050804403,60539
684,2022-01-14,98349,34539,35.11881157917213,63810
685,2022-01-15,75675,27566,36.42682523951107,48109
686,2022-01-16,43685,18230,41.730571134256614,25455
687,2022-01-17,96965,39590,40.829165162687566,57375
688,2022-01-18,135984,63669,46.820949523473345,72315
689,2022-01-19,138743,64656,46.60126997398067,74087
690,2022-01-20,137778,64093,46.51903787251956,73685
691,2022-01-21,137472,61397,44.66145833333333,76075
692,2022-01-22,110720,50925,45.99440028901734,59795
693,2022-01-23,52893,25854,48.87981396404061,27039
694,2022-01-24,111175,49923,44.90487969417585,61252
695,2022-01-25,150613,72475,48.12001620046079,78138
696,2022-01-26,142496,66653,46.775348079946106,75843
697,2022-01-27,129028,58280,45.16849056018849,70748
698,2022-01-28,116012,49753,42.88608075026721,66259
699,2022-01-29,82971,35285,42.526906991599475,47686
700,2022-01-30,41779,19106,45.73110893032385,22673
701,2022-01-31,87926,35549,40.430589359233906,52377
702,2022-02-01,109613,47180,43.04233986844626,62433
703,2022-02-02,93378,37633,40.301784146158624,55745
704,2022-02-03,83666,31810,38.020223268711305,51856
705,2022-02-04,75060,26160,34.85211830535572,48900
706,2022-02-05,55555,18744,33.73953739537395,36811
707,2022-02-06,27148,9781,36.02843671725358,17367
708,2022-02-07,63429,20031,31.580192025729552,43398
709,2022-02-08,77782,26433,33.98344089892263,51349
710,2022-02-09,63183,20045,31.725305857588275,43138
711,2022-02-10,53638,16375,30.52872963197733,37263
712,2022-02-11,56293,15221,27.038885829499225,41072
713,2022-02-12,39258,9841,25.06750216516379,29417
714,2022-02-13,21888,5792,26.46198830409357,16096
715,2022-02-14,54277,14066,25.915212705197415,40211
716,2022-02-15,58291,15218,26.10694618380196,43073
717,2022-02-16,50589,12712,25.127992251279924,37877
718,2022-02-17,44574,10821,24.276484048997172,33753
719,2022-02-18,44441,9626,21.660178663846448,34815
720,2022-02-19,32946,6403,19.434832756632066,26543
721,2022-02-20,17500,3683,21.045714285714286,13817
722,2022-02-21,42522,8906,20.944452283523823,33616
723,2022-02-22,48241,10577,21.925333222777304,37664
724,2022-02-23,43070,8915,20.698862317158113,34155
725,2022-02-24,41737,8040,19.26348324029039,33697
726,2022-02-25,43519,7258,16.67777292676762,36261
727,2022-02-26,29683,4626,15.584678098574942,25057
728,2022-02-27,14798,2642,17.85376402216516,12156
729,2022-02-28,36856,7222,19.595181245930107,29634
730,2022-03-01,38874,8453,21.744610793846785,30421
731,2022-03-02,36562,8046,22.00645478912532,28516
732,2022-03-03,35820,8260,23.05974316024567,27560
733,2022-03-04,35508,7556,21.279711614284107,27952
734,2022-03-05,28249,5830,20.637898686679172,22419
735,2022-03-06,16262,3920,24.10527610380027,12342
736,2022-03-07,39284,9709,24.71489665003564,29575
737,2022-03-08,46036,11520,25.023894343557217,34516
738,2022-03-09,41343,10327,24.97883559490119,31016
739,2022-03-10,37743,9882,26.182338446864318,27861
740,2022-03-11,35669,9226,25.86559757772856,26443
741,2022-03-12,27710,7296,26.32984482136413,20414
742,2022-03-13,16067,4029,25.076243231468226,12038
743,2022-03-14,43272,12298,28.420225550009242,30974
744,2022-03-15,53022,15259,28.77862019539059,37763
745,2022-03-16,45887,13367,29.130254756249048,32520
746,2022-03-17,42403,12535,29.561587623517205,29868
747,2022-03-18,39607,11407,28.800464564344686,28200
748,2022-03-19,28321,8074,28.508880336146326,20247
749,2022-03-20,15950,4776,29.943573667711597,11174
750,2022-03-21,41356,13095,31.664087435922234,28261
751,2022-03-22,53032,16700,31.490420877960478,36332
752,2022-03-23,47652,14544,30.52127927474188,33108
753,2022-03-24,44069,14345,32.55122648573827,29724
754,2022-03-25,39443,12360,31.336358796237608,27083
755,2022-03-26,29844,8775,29.40289505428227,21069
756,2022-03-27,14724,4357,29.591143710948113,10367
757,2022-03-28,43153,13907,32.227191620513054,29246
758,2022-03-29,52986,16105,30.394821273543954,36881
759,2022-03-30,46817,13877,29.640942392720593,32940
760,2022-03-31,42752,12132,28.37761976047904,30620
761,2022-04-01,42182,10468,24.816272343653694,31714
762,2022-04-02,29126,7106,24.397445581267597,22020
763,2022-04-03,14981,3731,24.90487951405113,11250
764,2022-04-04,36759,11371,30.93392094453059,25388
765,2022-04-05,42919,13391,31.20063375195135,29528
766,2022-04-06,38062,11752,30.875939257001733,26310
767,2022-04-07,34427,11164,32.42803613442937,23263
768,2022-04-08,32613,10075,30.892588844939134,22538
769,2022-04-09,22318,6432,28.819786719240074,15886
770,2022-04-10,11204,3031,27.052838272045697,8173
771,2022-04-11,31036,10401,33.51269493491429,20635
772,2022-04-12,33279,11252,33.81111211274377,22027
773,2022-04-13,29005,9603,33.108084812963284,19402
774,2022-04-14,26111,8887,34.03546398069779,17224
775,2022-04-15,24279,8311,34.23122863379876,15968
776,2022-04-16,16390,5465,33.343502135448446,10925
777,2022-04-17,8941,2729,30.522312940386982,6212
778,2022-04-18,10612,3134,29.53260459856766,7478
779,2022-04-19,29289,9858,33.657687186315684,19431
780,2022-04-20,30908,9948,32.18584185324188,20960
781,2022-04-21,24375,7954,32.631794871794874,16421
782,2022-04-22,22174,6805,30.689095336881035,15369
783,2022-04-23,16143,4228,26.190918664436598,11915
784,2022-04-24,8497,2031,23.902553842532658,6466
785,2022-04-25,23969,7145,29.809337060369646,16824
786,2022-04-26,26199,7398,28.237718996908278,18801
787,2022-04-27,22724,6083,26.76905474388312,16641
788,2022-04-28,19513,5409,27.71998155076103,14104
789,2022-04-29,18816,4785,25.430484693877553,14031
790,2022-04-30,14678,3425,23.33424172230549,11253
791,2022-05-01,7940,1606,20.226700251889167,6334
792,2022-05-02,22713,6073,26.737991458636024,16640
793,2022-05-03,25163,6545,26.01041211302309,18618
794,2022-05-04,22845,5604,24.53053184504268,17241
795,2022-05-05,21881,5551,25.369041634294593,16330
796,2022-05-06,21080,4892,23.206831119544592,16188
797,2022-05-07,15338,3211,20.93493284652497,12127
798,2022-05-08,7571,1472,19.442609959054284,6099
799,2022-05-09,22991,5569,24.22252185637858,17422
800,2022-05-10,24554,5782,23.548098069560968,18772
801,2022-05-11,21840,4869,22.293956043956044,16971
802,2022-05-12,18774,4034,21.48716309790135,14740
803,2022-05-13,19057,3655,19.179304192685105,15402
804,2022-05-14,12931,2107,16.294176784471425,10824
805,2022-05-15,6767,1016,15.014038717304567,5751
806,2022-05-16,19736,3849,19.50243210376976,15887
807,2022-05-17,20644,3883,18.80933927533424,16761
808,2022-05-18,17454,3138,17.97868683396356,14316
809,2022-05-19,15345,2586,16.852394916911045,12759
810,2022-05-20,15127,2280,15.072387122363985,12847
811,2022-05-21,10355,1478,14.273297923708354,8877
812,2022-05-22,5962,662,11.103656491110366,5300
813,2022-05-23,15025,2295,15.274542429284526,12730
814,2022-05-24,15279,2248,14.713004777799593,13031
815,2022-05-25,12891,1851,14.358855015126833,11040
816,2022-05-26,5466,701,12.824734723746797,4765
817,2022-05-27,11149,1520,13.633509731814513,9629
818,2022-05-28,8493,1050,12.363122571529495,7443
819,2022-05-29,5228,598,11.43840856924254,4630
820,2022-05-30,14451,2315,16.019652619195902,12136
821,2022-05-31,14658,2291,15.629690271524083,12367
822,2022-06-01,12972,2090,16.11162503854456,10882
823,2022-06-02,11864,1866,15.728253540121376,9998
824,2022-06-03,12078,1789,14.812054975989403,10289
825,2022-06-04,8516,1207,14.173320807891029,7309
826,2022-06-05,4684,673,14.368061485909479,4011
827,2022-06-06,5928,931,15.705128205128204,4997
828,2022-06-07,14066,3024,21.498649225081756,11042
829,2022-06-08,13616,2859,20.99735605170388,10757
830,2022-06-09,12025,2642,21.97089397089397,9383
831,2022-06-10,12928,2589,20.026299504950494,10339
832,2022-06-11,8414,1633,19.408129308295695,6781
833,2022-06-12,4097,721,17.598242616548696,3376
834,2022-06-13,13575,3671,27.042357274401475,9904
835,2022-06-14,14265,3775,26.463371889239397,10490
836,2022-06-15,13269,3594,27.085688446755597,9675
837,2022-06-16,12837,3424,26.6728986523331,9413
838,2022-06-17,13006,3323,25.549746270951868,9683
839,2022-06-18,8544,2035,23.817883895131086,6509
840,2022-06-19,4813,1063,22.086017037190942,3750
841,2022-06-20,15610,4803,30.76873798846893,10807
842,2022-06-21,17056,5062,29.67870544090056,11994
843,2022-06-22,16453,4921,29.909439008083634,11532
844,2022-06-23,15585,5009,32.13987808790504,10576
845,2022-06-24,17176,4895,28.49906846762925,12281
846,2022-06-25,11493,3045,26.494387888279824,8448
847,2022-06-26,6907,1560,22.58578253945273,5347
848,2022-06-27,20335,6834,33.607081386771576,13501
849,2022-06-28,23128,7346,31.76236596333449,15782
850,2022-06-29,22726,7297,32.10859808149256,15429
851,2022-06-30,23402,7085,30.275190154687632,16317
852,2022-07-01,23975,6552,27.32846715328467,17423
853,2022-07-02,17939,4583,25.54768939182786,13356
854,2022-07-03,7901,2024,25.617010504999367,5877
855,2022-07-04,25630,9708,37.877487319547406,15922
856,2022-07-05,28557,11112,38.91165038344364,17445
857,2022-07-06,25674,10176,39.63542883851367,15498
858,2022-07-07,24456,9447,38.628557409224726,15009
859,2022-07-08,25398,9078,35.7429718875502,16320
860,2022-07-09,16084,5266,32.74061178811241,10818
861,2022-07-10,7505,2475,32.978014656895404,5030
862,2022-07-11,24257,10007,41.25407098981737,14250
863,2022-07-12,26803,10707,39.94702085587434,16096
864,2022-07-13,24249,9375,38.66138809847829,14874
865,2022-07-14,21381,7730,36.15359431270754,13651
866,2022-07-15,23268,7400,31.803335052432523,15868
867,2022-07-16,14281,3980,27.869196834955535,10301
868,2022-07-17,6261,1749,27.934834690943937,4512
869,2022-07-18,19079,6815,35.71990146234079,12264
870,2022-07-19,19390,6597,34.022692109334706,12793
871,2022-07-20,18169,5794,31.889482084869837,12375
872,2022-07-21,7523,2056,27.32952279675661,5467
873,2022-07-22,16897,5433,32.153636740249745,11464
874,2022-07-23,10866,3392,31.216639057610895,7474
875,2022-07-24,5611,1498,26.697558367492423,4113
876,2022-07-25,17949,6331,35.27216000891414,11618
877,2022-07-26,17222,5923,34.39205667169899,11299
878,2022-07-27,15112,4858,32.14663843303335,10254
879,2022-07-28,14274,4307,30.17374246882444,9967
880,2022-07-29,15399,4136,26.858886940710434,11263
881,2022-07-30,10504,2408,22.924600152322924,8096
882,2022-07-31,4677,1064,22.749625828522557,3613
883,2022-08-01,15185,4974,32.75600921962463,10211
884,2022-08-02,14628,4441,30.359584358764014,10187
885,2022-08-03,12629,3627,28.719613587774173,9002
886,2022-08-04,11016,3137,28.47676107480029,7879
887,2022-08-05,11066,2856,25.808783661666368,8210
888,2022-08-06,7081,1619,22.864002259567858,5462
889,2022-08-07,3756,793,21.112886048988287,2963
890,2022-08-08,11516,3314,28.777353247655434,8202
891,2022-08-09,11495,3332,28.986515876468026,8163
892,2022-08-10,9741,2689,27.6049686890463,7052
893,2022-08-11,10094,2680,26.550425995640975,7414
894,2022-08-12,9724,2345,24.115590292060883,7379
895,2022-08-13,6485,1426,21.989205859676176,5059
896,2022-08-14,3427,669,19.521447330026263,2758
897,2022-08-15,4197,885,21.086490350250177,3312
898,2022-08-16,10773,3091,28.69210062192518,7682
899,2022-08-17,10718,2900,27.057286807240153,7818
900,2022-08-18,9369,2359,25.17878108656207,7010
901,2022-08-19,8996,1981,22.020898176967542,7015
902,2022-08-20,5828,1165,19.989704873026767,4663
903,2022-08-21,3013,548,18.187852638566213,2465
904,2022-08-22,9401,2384,25.35900436123817,7017
905,2022-08-23,9944,2376,23.893805309734514,7568
906,2022-08-24,8738,1915,21.915770199130236,6823
907,2022-08-25,8578,1857,21.64840289111681,6721
908,2022-08-26,8174,1660,20.308294592610718,6514
909,2022-08-27,5035,935,18.570009930486595,4100
910,2022-08-28,2999,530,17.672557519173058,2469
911,2022-08-29,9511,2200,23.1311113447587,7311
912,2022-08-30,10009,2071,20.691377760015985,7938
913,2022-08-31,9186,1863,20.280862181580666,7323
914,2022-09-01,8907,1886,21.174357247109015,7021
915,2022-09-02,9306,1764,18.95551257253385,7542
916,2022-09-03,6255,1009,16.13109512390088,5246
917,2022-09-04,3198,478,14.946841776110068,2720
918,2022-09-05,10573,2398,22.68041237113402,8175
919,2022-09-06,10926,2312,21.160534504850816,8614
920,2022-09-07,9959,2052,20.604478361281252,7907
921,2022-09-08,9395,1890,20.11708355508249,7505
922,2022-09-09,9838,1884,19.150233787355152,7954
923,2022-09-10,5998,1062,17.70590196732244,4936
924,2022-09-11,3203,484,15.110833593506086,2719
925,2022-09-12,11941,2662,22.292940289757976,9279
926,2022-09-13,13657,2713,19.865270557223404,10944
927,2022-09-14,12222,2475,20.250368188512518,9747
928,2022-09-15,10963,2104,19.19182705463833,8859
929,2022-09-16,11656,2124,18.222374742621824,9532
930,2022-09-17,6512,1173,18.01289926289926,5339
931,2022-09-18,3043,526,17.285573447256,2517
932,2022-09-19,13680,2962,21.65204678362573,10718
933,2022-09-20,17080,3287,19.24473067915691,13793
934,2022-09-21,14339,2825,19.70151335518516,11514
935,2022-09-22,13185,2734,20.7356844899507,10451
936,2022-09-23,13755,2760,20.065430752453654,10995
937,2022-09-24,7787,1641,21.07358417875947,6146
938,2022-09-25,3382,644,19.04198698994678,2738
939,2022-09-26,15832,3986,25.17685699848408,11846
940,2022-09-27,17763,4021,22.63694195800259,13742
941,2022-09-28,15966,3607,22.59175748465489,12359
942,2022-09-29,14851,3508,23.621304962628777,11343
943,2022-09-30,13906,3204,23.040414209693658,10702
944,2022-10-01,7649,1812,23.68937115962871,5837
945,2022-10-02,3793,833,21.961508041128393,2960
946,2022-10-03,15786,4389,27.803116685670847,11397
947,2022-10-04,19645,4956,25.22779333163655,14689
948,2022-10-05,16575,4096,24.71191553544495,12479
949,2022-10-06,15286,3734,24.427580792882374,11552
950,2022-10-07,14002,3347,23.903728038851593,10655
951,2022-10-08,7813,1856,23.755279662101625,5957
952,2022-10-09,4101,977,23.82345769324555,3124
953,2022-10-10,15960,4175,26.159147869674186,11785
954,2022-10-11,17848,4024,22.54594352308382,13824
955,2022-10-12,15048,3389,22.52126528442318,11659
956,2022-10-13,14260,3202,22.454417952314166,11058
957,2022-10-14,12998,2941,22.626557931989534,10057
958,2022-10-15,7002,1572,22.450728363324764,5430
959,2022-10-16,3293,667,20.255086547221378,2626
960,2022-10-17,14218,3498,24.602616401744267,10720
961,2022-10-18,13401,2928,21.849115737631518,10473
962,2022-10-19,11350,2258,19.894273127753305,9092
963,2022-10-20,10742,2087,19.428411841370323,8655
964,2022-10-21,9334,1821,19.509320762802655,7513
965,2022-10-22,5880,1013,17.227891156462587,4867
966,2022-10-23,2916,442,15.157750342935527,2474
967,2022-10-24,10513,2068,19.670883667839817,8445
968,2022-10-25,10492,1864,17.76591688905833,8628
969,2022-10-26,8692,1477,16.99263690750115,7215
970,2022-10-27,8070,1336,16.555142503097894,6734
971,2022-10-28,7303,1089,14.911680131452828,6214
972,2022-10-29,4884,612,12.530712530712531,4272
973,2022-10-30,2692,300,11.144130757800893,2392
974,2022-10-31,6847,1016,14.838615452022783,5831
975,2022-11-01,3152,363,11.516497461928935,2789
976,2022-11-02,7130,1092,15.315568022440393,6038
977,2022-11-03,6946,1016,14.627123524330548,5930
978,2022-11-04,6503,926,14.239581731508535,5577
979,2022-11-05,4318,536,12.413154238073181,3782
980,2022-11-06,2692,337,12.518573551263001,2355
981,2022-11-07,8109,1190,14.675052410901468,6919
982,2022-11-08,8266,1158,14.009194289862087,7108
983,2022-11-09,6961,971,13.949145237753196,5990
984,2022-11-10,5999,806,13.435572595432571,5193
985,2022-11-11,3126,364,11.64427383237364,2762
986,2022-11-12,3776,396,10.48728813559322,3380
987,2022-11-13,2699,248,9.188588366061504,2451
988,2022-11-14,7492,1043,13.921516284036306,6449
989,2022-11-15,8197,1138,13.883127973648895,7059
990,2022-11-16,7327,1017,13.880169237068376,6310
991,2022-11-17,6515,939,14.412893323100537,5576
992,2022-11-18,6426,933,14.519140989729227,5493
993,2022-11-19,4270,578,13.536299765807962,3692
994,2022-11-20,2444,241,9.86088379705401,2203
995,2022-11-21,8384,1253,14.94513358778626,7131
996,2022-11-22,8837,1291,14.609030213873487,7546
997,2022-11-23,7978,1276,15.993983454499874,6702
998,2022-11-24,7713,1272,16.49163749513808,6441
999,2022-11-25,7386,1204,16.30111020850257,6182
1000,2022-11-26,4804,692,14.40466278101582,4112
1001,2022-11-27,2768,300,10.83815028901734,2468
1002,2022-11-28,9728,1707,17.547286184210524,8021
1003,2022-11-29,9880,1643,16.629554655870447,8237
1004,2022-11-30,8907,1509,16.941731222633884,7398
1005,2022-12-01,8284,1471,17.75712216320618,6813
1006,2022-12-02,7988,1340,16.775162744116173,6648
1007,2022-12-03,5012,784,15.64245810055866,4228
1008,2022-12-04,2873,319,11.103376261747302,2554
1009,2022-12-05,10242,1773,17.311072056239016,8469
1010,2022-12-06,11235,1938,17.249666221628836,9297
1011,2022-12-07,10423,1936,18.57430682145256,8487
1012,2022-12-08,10198,1801,17.6603255540302,8397
1013,2022-12-09,9601,1681,17.508592854910944,7920
1014,2022-12-10,5602,929,16.58336308461264,4673
1015,2022-12-11,3629,549,15.12813447230642,3080
1016,2022-12-12,11284,1996,17.688762850053173,9288
1017,2022-12-13,12941,2090,16.150220230275867,10851
1018,2022-12-14,11294,1914,16.947051531786787,9380
1019,2022-12-15,10317,1728,16.74905495783658,8589
1020,2022-12-16,10231,1669,16.313165868439057,8562
1021,2022-12-17,6013,867,14.418759354731414,5146
1022,2022-12-18,3958,528,13.340070742799393,3430
1023,2022-12-19,12152,2011,16.548716260697827,10141
1024,2022-12-20,14244,2104,14.771131704577368,12140
1025,2022-12-21,12756,2051,16.07870805895265,10705
1026,2022-12-22,11838,1764,14.901165737455651,10074
1027,2022-12-23,11213,1640,14.625880674217425,9573
1028,2022-12-24,6262,822,13.126796550622805,5440
1029,2022-12-25,3607,442,12.25395065151095,3165
1030,2022-12-26,8874,1177,13.263466306062654,7697
1031,2022-12-27,10531,1430,13.578957363973032,9101
1032,2022-12-28,9706,1230,12.672573665773749,8476
1033,2022-12-29,9524,1210,12.704745905081898,8314
1034,2022-12-30,8674,1120,12.912151256629006,7554
1035,2022-12-31,5190,652,12.5626204238921,4538
1036,2023-01-01,3218,302,9.384711000621504,2916
1037,2023-01-02,8434,1063,12.60374673938819,7371
1038,2023-01-03,9418,1071,11.371841155234657,8347
1039,2023-01-04,8291,887,10.698347605837654,7404
1040,2023-01-05,7732,889,11.497672012415935,6843
1041,2023-01-06,7079,797,11.258652352027122,6282
1042,2023-01-07,4560,426,9.342105263157894,4134
1043,2023-01-08,2790,258,9.247311827956988,2532
1044,2023-01-09,6932,748,10.790536641661857,6184
1045,2023-01-10,7234,719,9.939176112800665,6515
1046,2023-01-11,6271,619,9.870833997767502,5652
1047,2023-01-12,5864,561,9.566848567530696,5303
1048,2023-01-13,5911,578,9.77837929284385,5333
1049,2023-01-14,3387,342,10.097431355181577,3045
1050,2023-01-15,2194,183,8.340929808568823,2011
1051,2023-01-16,5918,550,9.293680297397769,5368
1052,2023-01-17,6196,594,9.586830213040672,5602
1053,2023-01-18,5309,506,9.530985119608212,4803
1054,2023-01-19,4808,480,9.983361064891847,4328
1055,2023-01-20,4418,406,9.189678587596198,4012
1056,2023-01-21,2980,232,7.785234899328859,2748
1057,2023-01-22,2076,178,8.574181117533719,1898
1058,2023-01-23,5593,613,10.960128732344002,4980
1059,2023-01-24,5819,673,11.5655610929713,5146
1060,2023-01-25,5552,590,10.626801152737752,4962
1061,2023-01-26,5273,641,12.156267779252797,4632
1062,2023-01-27,5235,635,12.12989493791786,4600
1063,2023-01-28,3375,399,11.822222222222223,2976
1064,2023-01-29,2336,238,10.188356164383562,2098
1065,2023-01-30,6473,913,14.10474277769195,5560
1066,2023-01-31,7121,950,13.340822918129478,6171
1067,2023-02-01,6322,908,14.362543498892755,5414
1068,2023-02-02,6329,957,15.120872175699162,5372
1069,2023-02-03,6363,918,14.427157001414429,5445
1070,2023-02-04,3511,519,14.782113358017659,2992
1071,2023-02-05,2497,273,10.93311974369243,2224
1072,2023-02-06,7033,1276,18.14303995450021,5757
1073,2023-02-07,7307,1244,17.024770767756944,6063
1074,2023-02-08,6322,1094,17.304650427080038,5228
1075,2023-02-09,6476,1168,18.035824583075975,5308
1076,2023-02-10,6207,1104,17.78637022716288,5103
1077,2023-02-11,3981,673,16.905300175835215,3308
1078,2023-02-12,2635,414,15.71157495256167,2221
1079,2023-02-13,7763,1741,22.426896818240373,6022
1080,2023-02-14,8396,1779,21.188661267270128,6617
1081,2023-02-15,7374,1597,21.65717385408191,5777
1082,2023-02-16,7581,1642,21.659411687112517,5939
1083,2023-02-17,7065,1538,21.769285208775653,5527
1084,2023-02-18,4286,881,20.555296313579095,3405
1085,2023-02-19,2888,518,17.93628808864266,2370
1086,2023-02-20,7313,1914,26.172569396964313,5399
1087,2023-02-21,8147,2081,25.54314471584632,6066
1088,2023-02-22,6934,1728,24.920680703778483,5206
1089,2023-02-23,6912,1809,26.171875,5103
1090,2023-02-24,6293,1642,26.09248371206102,4651
1091,2023-02-25,3859,872,22.596527597823272,2987
1092,2023-02-26,2517,525,20.858164481525627,1992
1093,2023-02-27,8022,2246,27.998005484916476,5776
1094,2023-02-28,8050,2240,27.82608695652174,5810
1095,2023-03-01,7154,1918,26.810176125244617,5236
1096,2023-03-02,6794,1905,28.039446570503383,4889
1097,2023-03-03,6810,1890,27.75330396475771,4920
1098,2023-03-04,3939,981,24.904798172124902,2958
1099,2023-03-05,2659,585,22.000752162467094,2074
1100,2023-03-06,8378,2560,30.556218667939845,5818
1101,2023-03-07,8743,2710,30.996225551870065,6033
1102,2023-03-08,7553,2325,30.782470541506683,5228
1103,2023-03-09,7556,2264,29.962943356273158,5292
1104,2023-03-10,7301,2119,29.02342144911656,5182
1105,2023-03-11,3912,1019,26.0480572597137,2893
1106,2023-03-12,2638,610,23.12357846853677,2028
1107,2023-03-13,8037,2501,31.118576583302225,5536
1108,2023-03-14,8812,2669,30.288243304584654,6143
1109,2023-03-15,7071,2068,29.246216942440956,5003
1110,2023-03-16,6987,2051,29.354515528839276,4936
1111,2023-03-17,6576,1827,27.782846715328468,4749
1112,2023-03-18,3613,1017,28.14835316911154,2596
1113,2023-03-19,2364,530,22.419627749576986,1834
1114,2023-03-20,7461,2187,29.3124246079614,5274
1115,2023-03-21,7806,2092,26.79989751473226,5714
1116,2023-03-22,6788,1906,28.07896287566293,4882
1117,2023-03-23,6372,1773,27.82485875706215,4599
1118,2023-03-24,5850,1626,27.794871794871796,4224
1119,2023-03-25,3336,819,24.550359712230215,2517
1120,2023-03-26,2016,416,20.634920634920633,1600
1121,2023-03-27,6073,1639,26.98830890828256,4434
1122,2023-03-28,6243,1597,25.58065032836777,4646
1123,2023-03-29,5489,1388,25.28693751138641,4101
1124,2023-03-30,5320,1250,23.49624060150376,4070
1125,2023-03-31,5187,1130,21.7852323115481,4057
1126,2023-04-01,2911,572,19.649604946753694,2339
1127,2023-04-02,1922,355,18.470343392299686,1567
1128,2023-04-03,4630,1120,24.190064794816415,3510
1129,2023-04-04,4989,1186,23.77229905792744,3803
1130,2023-04-05,4213,974,23.118917635888916,3239
1131,2023-04-06,4241,904,21.31572742277765,3337
1132,2023-04-07,4122,798,19.359534206695777,3324
1133,2023-04-08,2556,457,17.879499217527385,2099
1134,2023-04-09,1626,277,17.035670356703566,1349
1135,2023-04-10,1915,324,16.91906005221932,1591
1136,2023-04-11,4469,950,21.257552025061536,3519
1137,2023-04-12,4403,906,20.576879400408814,3497
1138,2023-04-13,3973,812,20.437956204379564,3161
1139,2023-04-14,4125,709,17.187878787878788,3416
1140,2023-04-15,2399,376,15.67319716548562,2023
1141,2023-04-16,1547,227,14.673561732385263,1320
1142,2023-04-17,4228,802,18.968779564806056,3426
1143,2023-04-18,4113,678,16.484318016046682,3435
1144,2023-04-19,3642,618,16.96869851729819,3024
1145,2023-04-20,3452,583,16.888760139049825,2869
1146,2023-04-21,3496,570,16.304347826086957,2926
1147,2023-04-22,2020,277,13.712871287128714,1743
1148,2023-04-23,1508,188,12.46684350132626,1320
1149,2023-04-24,3770,584,15.490716180371352,3186
1150,2023-04-25,3858,639,16.56298600311042,3219
1151,2023-04-26,3581,520,14.521083496230103,3061
1152,2023-04-27,3216,439,13.650497512437813,2777
1153,2023-04-28,2930,395,13.48122866894198,2535
1154,2023-04-29,1750,207,11.82857142857143,1543
1155,2023-04-30,1369,155,11.322132943754564,1214
1156,2023-05-01,1415,188,13.286219081272085,1227
1157,2023-05-02,3251,453,13.934174100276838,2798
1158,2023-05-03,3134,428,13.656668793873644,2706
1159,2023-05-04,2640,365,13.825757575757574,2275
1160,2023-05-05,2714,333,12.269712601326455,2381
1161,2023-05-06,1585,186,11.735015772870662,1399
1162,2023-05-07,1207,139,11.516155758077879,1068
1163,2023-05-08,2852,317,11.115007012622721,2535
1164,2023-05-09,2845,335,11.775043936731107,2510
1165,2023-05-10,2524,283,11.212361331220286,2241
1166,2023-05-11,2261,230,10.172490048651039,2031
1167,2023-05-12,2064,221,10.70736434108527,1843
1168,2023-05-13,1248,120,9.615384615384617,1128
1169,2023-05-14,1084,79,7.287822878228782,1005
1170,2023-05-15,2793,247,8.843537414965986,2546
1171,2023-05-16,2649,250,9.437523593808985,2399
1172,2023-05-17,2431,240,9.872480460715755,2191
1173,2023-05-18,1065,86,8.075117370892018,979
1174,2023-05-19,2241,198,8.835341365461847,2043
1175,2023-05-20,1309,112,8.55614973262032,1197
1176,2023-05-21,1052,83,7.889733840304182,969
1177,2023-05-22,2395,243,10.146137787056366,2152
1178,2023-05-23,2346,189,8.05626598465473,2157
1179,2023-05-24,1992,175,8.785140562248996,1817
1180,2023-05-25,1871,151,8.070550507749866,1720
1181,2023-05-26,1748,154,8.810068649885583,1594
1182,2023-05-27,1050,85,8.095238095238095,965
1183,2023-05-28,834,52,6.235011990407674,782
1184,2023-05-29,852,55,6.455399061032864,797
1185,2023-05-30,1868,136,7.28051391862955,1732
1186,2023-05-31,1724,123,7.134570765661252,1601
1187,2023-06-01,1516,109,7.189973614775726,1407
1188,2023-06-02,1487,108,7.26294552790854,1379
1189,2023-06-03,851,71,8.343125734430082,780
1190,2023-06-04,650,38,5.846153846153846,612
1191,2023-06-05,1552,142,9.149484536082474,1410
1192,2023-06-06,1505,95,6.312292358803987,1410
1193,2023-06-07,1373,101,7.356154406409322,1272
1194,2023-06-08,1351,92,6.809770540340489,1259
1195,2023-06-09,1304,92,7.05521472392638,1212
1196,2023-06-10,756,49,6.481481481481481,707
1197,2023-06-11,675,44,6.518518518518518,631
1198,2023-06-12,1455,76,5.223367697594502,1379
1199,2023-06-13,1287,93,7.226107226107226,1194
1200,2023-06-14,1154,64,5.545927209705372,1090
1201,2023-06-15,1103,63,5.711695376246601,1040
1202,2023-06-16,1083,50,4.616805170821792,1033
1203,2023-06-17,635,36,5.669291338582677,599
1204,2023-06-18,576,22,3.8194444444444446,554
1205,2023-06-19,1189,52,4.373423044575273,1137
1206,2023-06-20,1025,57,5.560975609756098,968
1207,2023-06-21,925,40,4.324324324324325,885
1208,2023-06-22,1015,61,6.009852216748769,954
1209,2023-06-23,900,43,4.777777777777778,857
1210,2023-06-24,594,21,3.535353535353535,573
1211,2023-06-25,413,13,3.14769975786925,400
1212,2023-06-26,950,38,4.0,912
1213,2023-06-27,906,44,4.856512141280353,862
1214,2023-06-28,876,47,5.365296803652968,829
1215,2023-06-29,961,31,3.225806451612903,930
1216,2023-06-30,830,29,3.493975903614458,801
1217,2023-07-01,607,30,4.942339373970346,577
1218,2023-07-02,379,10,2.638522427440633,369
1219,2023-07-03,828,30,3.6231884057971016,798
1220,2023-07-04,813,29,3.5670356703567037,784
1221,2023-07-05,789,41,5.196451204055767,748
1222,2023-07-06,709,28,3.9492242595204514,681
1223,2023-07-07,764,38,4.973821989528796,726
1224,2023-07-08,445,16,3.5955056179775284,429
1225,2023-07-09,401,23,5.7356608478802995,378
1226,2023-07-10,822,49,5.961070559610706,773
1227,2023-07-11,796,45,5.653266331658291,751
1228,2023-07-12,717,44,6.136680613668061,673
1229,2023-07-13,777,49,6.306306306306306,728
1230,2023-07-14,737,41,5.563093622795115,696
1231,2023-07-15,379,17,4.485488126649076,362
1232,2023-07-16,364,19,5.21978021978022,345
1233,2023-07-17,747,46,6.157965194109773,701
1234,2023-07-18,693,41,5.916305916305916,652
1235,2023-07-19,626,50,7.987220447284344,576
1236,2023-07-20,714,44,6.162464985994398,670
1237,2023-07-21,341,14,4.105571847507331,327
1238,2023-07-22,374,29,7.754010695187167,345
1239,2023-07-23,364,34,9.340659340659341,330
1240,2023-07-24,716,52,7.262569832402235,664
1241,2023-07-25,685,56,8.175182481751825,629
1242,2023-07-26,635,64,10.078740157480315,571
1243,2023-07-27,629,66,10.492845786963434,563
1244,2023-07-28,691,76,10.998552821997105,615
1245,2023-07-29,359,34,9.47075208913649,325
1246,2023-07-30,318,27,8.49056603773585,291
1247,2023-07-31,720,86,11.944444444444445,634
1248,2023-08-01,694,90,12.968299711815561,604
1249,2023-08-02,639,90,14.084507042253522,549
1250,2023-08-03,642,100,15.57632398753894,542
1251,2023-08-04,657,102,15.52511415525114,555
1252,2023-08-05,404,61,15.099009900990099,343
1253,2023-08-06,360,52,14.444444444444443,308
1254,2023-08-07,875,149,17.02857142857143,726
1255,2023-08-08,907,166,18.30209481808159,741
1256,2023-08-09,832,143,17.1875,689
1257,2023-08-10,854,165,19.320843091334893,689
1258,2023-08-11,909,153,16.831683168316832,756
1259,2023-08-12,540,103,19.074074074074073,437
1260,2023-08-13,490,79,16.122448979591837,411
1261,2023-08-14,1101,218,19.80018165304269,883
1262,2023-08-15,554,104,18.772563176895307,450
1263,2023-08-16,1245,275,22.08835341365462,970
1264,2023-08-17,1244,253,20.337620578778136,991
1265,2023-08-18,1227,261,21.271393643031786,966
1266,2023-08-19,738,127,17.208672086720867,611
1267,2023-08-20,577,90,15.597920277296359,487
1268,2023-08-21,1392,302,21.695402298850574,1090
1269,2023-08-22,1435,318,22.1602787456446,1117
1270,2023-08-23,1349,273,20.237212750185325,1076
1271,2023-08-24,1508,307,20.358090185676392,1201
1272,2023-08-25,1534,308,20.078226857887874,1226
1273,2023-08-26,865,180,20.809248554913296,685
1274,2023-08-27,695,141,20.287769784172664,554
1275,2023-08-28,1655,391,23.62537764350453,1264
1276,2023-08-29,1658,381,22.979493365500602,1277
1277,2023-08-30,1558,360,23.106546854942234,1198
1278,2023-08-31,1576,364,23.096446700507613,1212
1279,2023-09-01,1595,359,22.50783699059561,1236
1280,2023-09-02,928,194,20.905172413793103,734
1281,2023-09-03,834,181,21.70263788968825,653
1282,2023-09-04,2103,558,26.533523537803138,1545
1283,2023-09-05,2145,537,25.034965034965033,1608
1284,2023-09-06,2023,491,24.270884824518042,1532
1285,2023-09-07,2134,478,22.399250234301782,1656
1286,2023-09-08,2121,458,21.593587930221595,1663
1287,2023-09-09,1207,245,20.298260149130073,962
1288,2023-09-10,1048,181,17.270992366412212,867
1289,2023-09-11,2470,526,21.295546558704455,1944
1290,2023-09-12,2553,558,21.856639247943598,1995
1291,2023-09-13,2121,432,20.367751060820368,1689
1292,2023-09-14,2041,464,22.73395394414503,1577
1293,2023-09-15,2084,376,18.042226487523994,1708
1294,2023-09-16,1175,221,18.808510638297875,954
1295,2023-09-17,1026,178,17.348927875243664,848
1296,2023-09-18,2635,527,20.0,2108
1297,2023-09-19,2341,451,19.265271251601877,1890
1298,2023-09-20,2248,437,19.439501779359432,1811
1299,2023-09-21,2229,424,19.02198295199641,1805
1300,2023-09-22,2079,393,18.9033189033189,1686
1301,2023-09-23,1141,192,16.827344434706397,949
1302,2023-09-24,935,166,17.754010695187166,769
1303,2023-09-25,2359,471,19.96608732513777,1888
1304,2023-09-26,2456,509,20.724755700325733,1947
1305,2023-09-27,2301,428,18.600608431116903,1873
1306,2023-09-28,2183,428,19.606046724690792,1755
1307,2023-09-29,2266,451,19.902912621359224,1815
1308,2023-09-30,1187,205,17.270429654591407,982
1309,2023-10-01,1120,197,17.589285714285715,923
1310,2023-10-02,2491,484,19.429947812123647,2007
1311,2023-10-03,2435,479,19.67145790554415,1956
1312,2023-10-04,2211,430,19.448213478064226,1781
1313,2023-10-05,2013,396,19.672131147540984,1617
1314,2023-10-06,2188,374,17.09323583180987,1814
1315,2023-10-07,1170,208,17.77777777777778,962
1316,2023-10-08,1183,217,18.34319526627219,966
1317,2023-10-09,2427,454,18.706221672847136,1973
1318,2023-10-10,2468,417,16.896272285251214,2051
1319,2023-10-11,2086,373,17.88111217641419,1713
1320,2023-10-12,2091,363,17.360114777618367,1728
1321,2023-10-13,2207,364,16.4929768917082,1843
1322,2023-10-14,1148,167,14.547038327526133,981
1323,2023-10-15,1071,144,13.445378151260504,927
1324,2023-10-16,2286,360,15.748031496062993,1926
1325,2023-10-17,2130,354,16.619718309859156,1776
1326,2023-10-18,2078,345,16.60250240615977,1733
1327,2023-10-19,2235,370,16.55480984340045,1865
1328,2023-10-20,2261,388,17.160548429898277,1873
1329,2023-10-21,1292,221,17.105263157894736,1071
1330,2023-10-22,1214,179,14.744645799011533,1035
1331,2023-10-23,2685,427,15.90316573556797,2258
1332,2023-10-24,2144,338,15.764925373134329,1806
1333,2023-10-25,2126,320,15.051740357478833,1806
1334,2023-10-26,2002,319,15.934065934065933,1683
1335,2023-10-27,2111,313,14.827096162955943,1798
1336,2023-10-28,1290,148,11.472868217054263,1142
1337,2023-10-29,1276,158,12.38244514106583,1118
1338,2023-10-30,2260,342,15.132743362831857,1918
1339,2023-10-31,2215,305,13.769751693002258,1910
1340,2023-11-01,1240,160,12.903225806451612,1080
1341,2023-11-02,2080,308,14.807692307692308,1772
1342,2023-11-03,2042,275,13.46718903036239,1767
1343,2023-11-04,1257,157,12.49005568814638,1100
1344,2023-11-05,1375,149,10.836363636363638,1226
1345,2023-11-06,2328,327,14.04639175257732,2001
1346,2023-11-07,2017,292,14.476945959345564,1725
1347,2023-11-08,1860,257,13.81720430107527,1603
1348,2023-11-09,1925,262,13.610389610389612,1663
1349,2023-11-10,1969,268,13.61097003555104,1701
1350,2023-11-11,1140,134,11.75438596491228,1006
1351,2023-11-12,1159,121,10.440034512510785,1038
1352,2023-11-13,2276,319,14.015817223198592,1957
1353,2023-11-14,2173,298,13.713759779107226,1875
1354,2023-11-15,2007,289,14.39960139511709,1718
1355,2023-11-16,1998,259,12.962962962962962,1739
1356,2023-11-17,1932,273,14.130434782608695,1659
1357,2023-11-18,1216,161,13.240131578947366,1055
1358,2023-11-19,1220,148,12.131147540983607,1072
1359,2023-11-20,2365,373,15.771670190274842,1992
1360,2023-11-21,2216,314,14.169675090252706,1902
1361,2023-11-22,2039,304,14.909269249632173,1735
1362,2023-11-23,2017,330,16.36093207734259,1687
1363,2023-11-24,2122,306,14.420358152686145,1816
1364,2023-11-25,1247,161,12.910986367281478,1086
1365,2023-11-26,1309,161,12.299465240641712,1148
1366,2023-11-27,2441,396,16.22285948381811,2045
1367,2023-11-28,109,16,14.678899082568808,93
